{
    "BG": 0,
    "ED": 1,
    "F": 1,
    "JF": 1,
    "LF": 1,
    "SO": 1,
    "X": 1
}
